000m000000000000000000000000
0000110000101010111011110001
1111111111100000000000000000
0000000000000111111111111111
0000000000000000000000000000
0000000101010101010101010100
1011110000000000000000000000
000000e000000000000000000000

